{
    "speedMultiplier": 2.2,
    "distanceMultiplier": 1.0,
    "speedAcceleration": 2.0,
    "maxWorldSpeed": 1600.0,
    "map": [
        6,7,8,7,6,9,5,2,4,2,5,3,4,3,8,9,0,1,0,
        1,2,9,8,3,4,5,4,5,4,5,4,5,4,5,0,1,0,1,
        8,3,6,3,8,3,2,3,8,9,6,7,0,2,1,2,0,3,9,
        6,9,6,9,8,9,3,8,9,2,9,9,2,9,9,2,4,5,8,
        9,3,8,9,8,3,3,4,5,4,5,0,1,0,1,2,3,3,8,
        6,9,6,9,6,0,1,6,9,3,6,0,9,8,9,6,8,0,9,
        6,7,6,7,6,3,3,6,3,8,9,8,9,8,1,8,0,8,1
    ]
}
