{
    "speedMultiplier": 1.5,
    "distanceMultiplier": 1.6,
    "speedAcceleration": 1.5,
    "maxWorldSpeed": 1000.0,
    "map": [
        0,1,0,1,0,1,2,3,0,1,0,1,2,3,0,1,0,1,2,
        3,0,1,0,1,4,5,0,1,2,3,0,1,0,1,2,3,8,9,
        0,1,0,1,2,3,2,3,0,1,0,1,4,5,2,3,0,1,0,
        1,2,3,8,9,0,1,0,1,2,3,0,1,4,5,2,3,0,1,
        0,1,2,3,0,1,2,3,8,9,0,1,0,1,2,3,4,5,0,
        1,2,3,0,1,0,1,2,3,2,3,0,1,8,9,0,1,2,3,
        0,1,0,1,2,3,0,1,4,5,2,3,0,1,0,1,2,3,2
    ]
}
